XXXXXXXXXXXXXXXXXXXX
XXXXX------XXXXXXXXX
XX-----------XXXXXXX
X----XXXX------XXXXX
X---XXX-------XXXXXX
X---X------XXXXXXXXX
X---X----XXXXXXXXXXX
X---X---XXXXXXXXXXXX
X-P-X---XXXXXXXXXXXX
XXXXX---XXXXX----XXX
XFFFX---XXXX-------X
X---X---XX---------X
X---X---------X----X
X---XX------XXXX---X
X---XXXXXXXXXXXX---X
X---XXXXXXXXXXX----X
X----XXX-----------X
XX-----------------X
XXXX-----------XXXXX
XXXXXXXXXXXXXXXXXXXX