XXXXXXXXXXXXXXXXXXXXXXXXXXXXXXXXXX
XXX------XXXXXXXXXXXXXXXXFFFFFFFXX
XX---------XXXXXXXXXXXXXXX-------X
XX-----------XXXXXXXXXXXX--------X
XX------------XXXXXXXX-----------X
XX-----XX-----XXXXXX------------XX
XX----XXXX-----XXXXX---------XXXXX
X----XXXXX-----XXXXX------XXXXXXXX
X----XXXXXX-----XXXX-----XXXXXXXXX
X----XXXXXX------XXX-------XXXXXXX
X-----XXXXX-------XXX---------XXXX
XX----XXXXX-------XXXXX---------XX
XX-----XXXX------XXXXXXXX--------X
XXX-----XXX-------XXXXXX---------X
XXXX----XXXX--------------------XX
XXXXX-P-XXXXXX---------------XXXXX
XXXXXXXXXXXXXXXXX----------XXXXXXX
XXXXXXXXXXXXXXXXXXXXXXXXXXXXXXXXXX
