##########
##---##--#
#--------F
#P--###--F
#--------F
####----##
##########
