###############
##--P------####
#####--------##
#######----####
####------#####
##----#########
#----####--####
#-----##----###
###----------##
#####---##----#
##--#######---#
##FFF#####----#
##-----------##
####-------####
###############