XXXXXXXXXXXXXXX
XX---P-----XXXX
XXXXX--------XX
XXXXXXX----XXXX
XXXX------XXXXX
XX----XXXXXXXXX
X----XXXX--XXXX
X-----XX----XXX
XXX----------XX
XXXXX---XX----X
XX--XXXXXXX---X
XXFFFXXXXX----X
XX-----------XX
XXXX-------XXXX
XXXXXXXXXXXXXXX